...###
..##.#.####
.#...###..#
#..#......#
#...#..#..#
#.#..#.##.#
..#..#....#
.##.##.#...
.#........
.#..@..##
.#######